11111111111111111111111111111111111111
11111111111111111111111111111111111111
111EP000000000000C00000C10000000000111
11111001010011000010100101000001010111
11010010010101110001001010000010111111
11100000000C01C100000000000000000C1111
11111111111111111111111111111111111111
11111111111111111111111111111111111111