1111111
10000P1
1000001
100C001
100E001
1111111