11111111111111111111111111111111111111111111111111
1P0000000000000010000000000000000000000000000000C1
10001111111111000111111111111111111111111111111001
1C001000000000000000000000000000000000000000010001
10001000111111111111111111111111111111111101000111
10001000100000000000000000000000000000000101000111
10001000101111111111111111111111111111110101000111
10001000101000000000000000000000000000010101000111
10001000101001111111111111111111111110010101000111
10001000101001000000000000000000000010010101000111
10001000101001001111111111111111111010010101000111
10001000101001001000000000000000001010010101000111
10001000101001001001111111111111001010010101000111
1C0010000101001001001000000000001001010010001C0011
10001000010100100100100111111100100101001000010011
10001000101001001001001000000100100101001000010011
10001000101001001001001011110100100101001000010011
10001000101001001001001010010100100101001000010011
10001000101001001001001010010100100101001000010011
10001000101001001001001011110100100101001000010011
10001000101001001001001000000100100101001000010011
10001000101001001001001011111100100101001000010011
10001000101001001001000000000000000101001000010011
10001000101001001111111111111111111010010000100011
10001000101001000000000000000000000010010000100011
10001000101111111111111111111111111110010000100011
10001000100000000000000000000000000000010000100011
10001000111111111111111111111111111111010000100011
10001000000000000000000000000000000001010000100011
1C001111111111111111111111111111111010111111110011
10000000000000000000000000000000000100000000000011
10001111111111111111111111111111111111111111111011
10001000000000000000000000000000000000000000001011
10001011111111111111111111111111111111111111101011
10001010000000000000000000000000000000000000101011
10001010101001001111111111101001001010001010101011
10001010101000000000000000001001001010001010101011
10001010101111111111111111111001001011111010101011
10001010000000000000000000000000001000000010101011
10001111111111111111111111111111111111111111111011
1C00000000000000000000000000000000000000000000E111
11111111111111111111111111111111111111111111111111