11111
11011
10001
10C01
10001
11E11
10001
10001
1C0C1
1PC01
11111